%%%%%%%%%%%%%%%%%%%%%%%%%%%%
%%%%%%%%%%%%%%%%%%%%%%%%%%%%
%%%%%%%%%%%%%%%%%%%%%%%%%%%%
%%%%%%%%          %%%%%%%%%%
%%%%%%%%          %%%%%%%%%%
%%%%%%%%          %%%%%%%%%%
%%%%%%%%          %%%%%%%%%%
%%%%%%%%     .....%%%%%%%%%%
%%%%%%%%    ......%%%%%%%%%%
%%%%%%%%    ......%%%%%%%%%%
%%%%%%%%    ......%%%%%%%%%%
%%%%%%%%    ......%%%%%%%%%%
%%%%%%%%    ......%%%%%%%%%%
%%%%%%%%     .....%%%%%%%%%%
%%%%%%%%          %%%%%%%%%%
%%%%%%%%          %%%%%%%%%%
%%%%%%%%          %%%%%%%%%%
%%%%%%%%          %%%%%%%%%%
%%%%%%%%%%%%%%%%%%%%%%%%%%%%
%%%%%%%%%%%%%%%%%%%%%%%%%%%%
%%%%%%%%%%%%%%%%%%%%%%%%%%%%
%%%%%%%%%%%%%%%%%%%%%%%%%%%%
#
%%%%%%%%%%%%%%%%%%%%%%%%%%%%
%%%%%%%%%%%%%%%%%%%%%%%%%%%%
%%%%%%%%%%%%%%%%%%%%%%%%%%%%
%%%%%%%%%%%%%%%%%%%%%%%%%%%%
%%%%%%%%%%%%%%%%%%%%%%%%%%%%
%%%%%             ....%%%%%%
%%%%%            .....%%%%%%
%%%%%  P        ......%%%%%%
%%%%%          .......%%%%%%
%%%%%          .......%%%%%%
%%%%%          .......%%%%%%
%%%%%          .......%%%%%%
%%%%%          .......%%%%%%
%%%%%           ......%%%%%%
%%%%%            .....%%%%%%
%%%%%             ....%%%%%%
%%%%%                 %%%%%%
%%%%%%%%%%%%%%%%%%%%%%%%%%%%
%%%%%%%%%%%%%%%%%%%%%%%%%%%%
%%%%%%%%%%%%%%%%%%%%%%%%%%%%
%%%%%%%%%%%%%%%%%%%%%%%%%%%%
%%%%%%%%%%%%%%%%%%%%%%%%%%%%
#
%%%%%%%%%%%%%%%%%%%%%%%%%%%%
%%%%%%%%%%%%%%%%%%%%%%%%%%%%
%%%%%%%%%%%%%%%%%%%%%%%%%%%%
%%%%%%%%%%%%%%%%%%%%%%%%%%%%
%%%%%%%%%%%%%%%%%%%%%%%%%%%%
%%%%%%%%%%%%%%%%%%%%%%%%%%%%
%%%%%%%%%%%%%%%%%%%%%%%%%%%%
%%%%%%%%%%%%%%%%%%%%%%%%%%%%
%%%              ......%%%%%
%%%              ......%%%%%
%%%              ......%%%%%
%%%              ......%%%%%
%%%              ......%%%%%
%%%%%%%%%%%%%%%%%%%%%%%%%%%%
%%%%%%%%%%%%%%%%%%%%%%%%%%%%
%%%%%%%%%%%%%%%%%%%%%%%%%%%%
%%%%%%%%%%%%%%%%%%%%%%%%%%%%
%%%%%%%%%%%%%%%%%%%%%%%%%%%%
%%%%%%%%%%%%%%%%%%%%%%%%%%%%
%%%%%%%%%%%%%%%%%%%%%%%%%%%%
%%%%%%%%%%%%%%%%%%%%%%%%%%%%
%%%%%%%%%%%%%%%%%%%%%%%%%%%%
#
