%%%%%%%%%%%%%%%%%%%%%%%%%%%%%%%%%%%%%%%%%%%%%%%%%%%%%%%%
%%%%%%%%%%%%%%%%%%%%%%%%%%%%%%%%%%%%%%%%%%%%%%%%%%%%%%%%
%%%%%%%%%%%%%%%%%%%%%%%%%%%%%%%%%%%%%%%%%%%%%%%%%%%%%%%%
%%%%%%%%                    %%%%%%%%%%%%%%%%%%%%%%%%%%%%
%%%%%%%%                   %%%%%%%%%%%%%%%%%%%%%%%%%%%%%
%%%%%%%%        %%%%%%%%%%%%%%%%%%%%%%%%%     %%%%%%%%%%
%%%%%%%%        %%%%%%%%%%%%%%%%%%%%%%%%%     %%%%%%%%%%
%%%%%%%%        %%%%%%%%%%%%%%%%%%%%%%%%      %%%%%%%%%%
%%%%%%%%        %%%%%%%%%%%%%%%%%%%%%%%       %%%%%%%%%%
%%%%%%%%        %%%%%%%%%%%%%%.......         %%%%%%%%%%
%%%%%%%%        %%%%%%%%%%%%%%.......         %%%%%%%%%%
%%%%%%%%        %%%%%%%%%%%%%%.......         %%%%%%%%%%
%%%%%%%%        %%%%%%%%%%%%%%%%%%%%%%%       %%%%%%%%%%
%%%%%%%%        %%%%%%%%%%%%%%%%%%%%%%%%      %%%%%%%%%%
%%%%%%%%        %%%%%%%%%%%%%%%%%%%%%%%%%     %%%%%%%%%%
%%%%%%%%        %%%%%%%%%%%%%%%%%%%%%%%%%     %%%%%%%%%%
%%%%%%%%                   %%%%%%%%%%%%%%%%%%%%%%%%%%%%%
%%%%%%%%                    %%%%%%%%%%%%%%%%%%%%%%%%%%%%
%%%%%%%%                    %%%%%%%%%%%%%%%%%%%%%%%%%%%%
%%%%%%%%                     %%%%%%%%%%%%%%%%%%%%%%%%%%%
%%%%%%%%                          %%%%%%%%%%%%%%%%%%%%%%
%%%%%%%%%%%%%%%%%%%%%%%%%%%%%%%% %%%%%%%%%%%%%%%%%%%%%%%
%%%%%%%%%%%%%%%%%%%%%%%%%%%%%%%%%%%%%%%%%%%%%%%%%%%%%%%%
%%%%%%%%%%%%%%%%%%%%%%%%%%%%%%%%%%%%%%%%%%%%%%%%%%%%%%%%
%%%%%%%%%%%%%%%%%%%%%%%%%%%%%%%%%%%%%%%%%%%%%%%%%%%%%%%%
%%%%%%%%             %%%%%%%%%%%%%%%%%%%%%%%% %%%%%%%%%%
%%%%%%%%                %%%%%%%%%%%%%%%%%%%%  %%%%%%%%%%
%%%%%%%%                   %%%%%%%%%%%%%%%%   %%%%%%%%%%
%%%%%%%%                     %%%%%%%%%%%%%    %%%%%%%%%%
%%%%%%%%                                      %%%%%%%%%%
%%%%%%%%                                      %%%%%%%%%%
%%%%%%%%                                      %%%%%%%%%%
%%%%%%%%                                      %%%%%%%%%%
%%%%%%%%                      %%%%%%%%%%%%%%%%%%%%%%%%%%
%%%%%%%%                  %%%%%%%%%%%%%%%%%%%%%%%%%%%%%%
%%%%%%%%              %%%%%%%%%%%%%%%%%%%%%%%%%%%%%%%%%%
%%%%%%%%%%%%%%%%%%%%%%%%%%%%%%%%%%%%%%%%%%%%%%%%%%%%%%%%
%%%%%%%%%%%%%%%%%%%%%%%%%%%%%%%%%%%%%%%%%%%%%%%%%%%%%%%%
%%%%%%%%%%%%%%%%%%%%%%%%%%%%%%%%%%%%%           %%%%%%%%
%%%%%%%%%%%%%%%%%%%%%%%%%%%%%%%%%               %%%%%%%%
%%%%%%%%                                        %%%%%%%%
%%%%%%%%                                        %%%%%%%%
%%%%%%%%                                        %%%%%%%%
%%%%%%%%                                        %%%%%%%%
%%%%%%%%                                        %%%%%%%%
%%%%%%%%                                        %%%%%%%%
%%%%%%%%                                        %%%%%%%%
%%%%%%%%                                        %%%%%%%%
%%%%%%%%%%%%%%%%%%%%%%%%%%%%%%%%%%%%%%%%%%%%%%%%%%%%%%%%
%%%%%%%%%%%%%%%%%%%%%%%%%%%%%%%%%%%%%%%%%%%%%%%%%%%%%%%%
%%%%%%%%%%%%%%%%%%%%%%%%%%%%%%%%%%%%%%%%%%%%%%%%%%%%%%%%
#
%%%%%%%%%%%%%%%%%%%%%%%%%%%%%%%%%%%%%%%%%%%%%%%%%%%%%%%%
%%%%%%%%%%%%%%%%%%%%%%%%%%%%%%%%%%%%%%%%%%%%%%%%%%%%%%%%
%%%%%%%%%%%%%%%%%%%%%%%%%%%%%%%%%%%%%%%%%%%%%%%%%%%%%%%%
%%%%%%%%%%%%%%%%%%%%%%%%%%%%%%%%%%%%%%%%%%%%%%%%%%%%%%%%
%%%%                %%%%%%%%%%%%%%%%%%%%%%%%%%%%%%%%%%%%
%%%%               %%%%%%%%%%%%%%%%%%%%%%%%%%%%%%%%%%%%%
%%%%               %%%%%%%%%%%%%%%%%%%%%%%%%%%%%%%%%%%%%
%%%%               %%%%%%%%%%%%%%%%%%            %%%%%%%
%%%%               %%%%%%%%%%%%%%%%%             %%%%%%%
%%%%               %%%%%%%%%%%%%%%%%             %%%%%%%
%%%%               %%%%%%%%%%%%%%%               %%%%%%%
%%%%               %%%%%%%%%%%%%%%%%             %%%%%%%
%%%%               %%%%%%%%%%%%%%%%%             %%%%%%%
%%%%               %%%%%%%%%%%%%%%%%%            %%%%%%%
%%%%               %%%%%%%%%%%%%%%%%%%%%%%%%%%   %%%%%%%
%%%%               %%%%%%%%%%%%%%%%%%%%%%%%%%%%  %%%%%%%
%%%%                %%%%%%%%%%%%%%%%%%%%%%%%%%%% %%%%%%%
%%%%                 %%%%%%%%%%%%%%%%%%%%%%%%%%% %%%%%%%
%%%%                           %%%%%%%%%%%%%%%%% %%%%%%%
%%%%%%%%%%%%%%%%%%%%%%%%%%%     %%%%%%%%%%%%%%%% %%%%%%%
%%%%%%%%%%%%%%%%%%%%%%%%%%%%%%   %%%%%%%%%%%%%%  %%%%%%%
%%%%%%%%%%%%%%%%%%%%%%%%%%%%%%%%  %%%%%%%%%%%%   %%%%%%%
%%%%%%%%%%%%%%%%%%%%%%%%%%%%%%%%%%%%%%%%%%%%%    %%%%%%%
%%%%%%%%%%%%%%%%%%%%%%%%%%%%%%%%%%%%%%%%%%%%     %%%%%%%
%%%%%%%%%%%%%%%%%%%%%%%%%%%%%%%%%%%%%%%%%%%      %%%%%%%
%%%%%%%%%%%%%%%%%%%%%%%%%%%%%%%%%%%%%%%%%%       %%%%%%%
%%%%%%%%%%%%%%%%%%%%%%%%%%%%%%%%%%%%%%%%%        %%%%%%%
%%%%                       %%%%%%%%%%%%%         %%%%%%%
%%%%                         %%%%%%%%%%          %%%%%%%
%%%%                            %%%%%%           %%%%%%%
%%%%   P                           %             %%%%%%%
%%%%                                             %%%%%%%
%%%%                            %%%%%%%%%%%%%%%%%%%%%%%%
%%%%                        %%%%%%%%%%%%%%%%%%%%%%%%%%%%
%%%%%%%%%%%%%%%%%%%%%%%%%%%%%%%%%%%%%%%%%%%%%%%%%%%%%%%%
%%%%%%%%%%%%%%%%%%%%%%%%%%%%%%%%%%%%%%%%%%%%%%%%%%%%%%%%
%%%%%%%%%%%%%%%%%%%%%%%%%%%%%%%%%%%%%%%%%%%%%%%%%%%%%%%%
%%%%%%%%%%%%%%%%%%%%%%%%%%%%%%%%%%%%%%%%%%%%%%%%%%%%%%%%
%%%%%%%%%%%%%%%%%%%%%%%%%%%%%%%%%%%%%%%%%%%%%%%%%%%%%%%%
%%%%%%%%%%%%%%%%%%%%%%%%%%%%%%%%%%%                 %%%%
%%%%%%%%%%%%%%%%%%%%%%%%%%%%%%%                     %%%%
%%%%%%%%%%%%%%%%%%%%%%%%%%%                         %%%%
%%%%                                                %%%%
%%%%                                                %%%%
%%%%                                                %%%%
%%%%                                                %%%%
%%%%                                                %%%%
%%%%%%%%%%%%%%%%%%%%%%%%%%%%%%%%%%%%%%%%%%%%%%%%%%%%%%%%
%%%%%%%%%%%%%%%%%%%%%%%%%%%%%%%%%%%%%%%%%%%%%%%%%%%%%%%%
%%%%%%%%%%%%%%%%%%%%%%%%%%%%%%%%%%%%%%%%%%%%%%%%%%%%%%%%
%%%%%%%%%%%%%%%%%%%%%%%%%%%%%%%%%%%%%%%%%%%%%%%%%%%%%%%%
#
%%%%%%%%%%%%%%%%%%%%%%%%%%%%%%%%%%%%%%%%%%%%%%%%%%%%%%%%
%%%%%%%%%%%%%%%%%%%%%%%%%%%%%%%%%%%%%%%%%%%%%%%%%%%%%%%%
%%%%%%%%%%%%%%%%%%%%%%%%%%%%%%%%%%%%%%%%%%%%%%%%%%%%%%%%
%%%%%%%%%%%%%%%%%%%%%%%%%%%%%%%%%%%%%%%%%%%%%%%%%%%%%%%%
%%%%%%%%%%%%%%%%%%%%%%%%%%%%%%%%%%%%%%%%%%%%%%%%%%%%%%%%
%%%%%%%%%%%%%%%%%%%%%%%%%%%%%%%%%%%%%%%%%%%%%%%%%%%%%%%%
%%%%%%%%%%%%%%%%%%%%%%%%%%%%%%%%%%%%%%%%%%%%%%%%%%%%%%%%
%%%%%%%%%%%%%%%%%%%%%%%%%%%%%%%%%%%%%%%%%%%%%%%%%%%%%%%%
%%%                  %%%%%%%%%%%%%%%%%%%%%%%%%%%%%%%%%%%
%%%                  %%%%%%%%%%%%%%%%%%%%%%%%%%%%%%%%%%%
%%%                  %%%%%%%%%%%%%%%               %%%%%
%%%                  %%%%%%%%%%%%%%%%%%%%%%%%%     %%%%%
%%%                  %%%%%%%%%%%%%%%%%%%%%%%%%     %%%%%
%%%                  %%%%%%%%%%%%%%%%%%%%%%%%%     %%%%%
%%%                  %%%%%%%%%%%%%%%%%%%%%%%%%     %%%%%
%%%                  %%%%%%%%%%%%%%%%%%%%%%%%%     %%%%%
%%%%%%%%%%%%%%%%%%%%%%%%%%%%%%%%%%%%%%%%%%%%%%     %%%%%
%%%%%%%%%%%%%%%%%%%%%%%%%%%%%%%%%%%%%%%%%%%%%%     %%%%%
%%%%%%%%%%%%%%%%%%%%%%%%%%%%%%%%%%%%%%%%%%%%%%     %%%%%
%%%%%%%%%%%%%%%%%%%%%%%%%%%%%%%%%%%%%%%%%%%%%%     %%%%%
%%%%%%%%%%%%%%%%%%%%%%%%%%%%%%%%%%%%%%%%%%%%%%     %%%%%
%%%%%%%%%%%%%%%%%%%%%%%%%%%%%%%%%%%%%%%%%%%%%%     %%%%%
%%%%%%%%%%%%%%%%%%%%%%%%%%%%%%%%%%%%%%%%%%%%%%     %%%%%
%%%%%%%%%%%%%%%%%%%%%%%%%%%%%%%%%%%%%%%%%%%%%%     %%%%%
%%%%%%%%%%%%%%%%%%%%%%%%%%%%%%%%%%%%%%%%%%%%%%     %%%%%
%%%%%%%%%%%%%%%%%%%%%%%%%%%%%%%%%%%%%%%%%%%%%      %%%%%
%%%%%%%%%%%%%%%%%%%%%%%%%%%%%%%%%%%%%%%%%%%%       %%%%%
%%%%%%%%%%%%%%%%%%%%%%%%%%%%%%%%%%%%%%%%%%%        %%%%%
%%%%%%%%%%%%%%%%%%%%%%%%%%%%%%%%%%%%%%%%%%%%%%%%%%%%%%%%
%%%%%%%%%%%%%%%%%%%%%%%%%%%%%%%%%%%%%%%%%%%%%%%%%%%%%%%%
%%%                       %%%%%%%%%%%%%%%%%%%%%%%%%%%%%%
%%%%%%%%%%%%%%%%%%%%%%%%%%%%%%%%%%%%%%%%%%%%%%%%%%%%%%%%
%%%%%%%%%%%%%%%%%%%%%%%%%%%%%%%%%%%%%%%%%%%%%%%%%%%%%%%%
%%%%%%%%%%%%%%%%%%%%%%%%%%%%%%%%%%%%%%%%%%%%%%%%%%%%%%%%
%%%%%%%%%%%%%%%%%%%%%%%%%%%%%%%%%%%%%%%%%%%%%%%%%%%%%%%%
%%%%%%%%%%%%%%%%%%%%%%%%%%%%%%%%%%%%%%%%%%%%%%%%%%%%%%%%
%%%%%%%%%%%%%%%%%%%%%%%%%%%%%%%%%%%%%%%%%%%%%%%%%%%%%%%%
%%%%%%%%%%%%%%%%%%%%%%%%%%%%%%%%%%%%%%%%%%%%%%%%%%%%%%%%
%%%%%%%%%%%%%%%%%%%%%%%%%%%%%%%%%%%%%%%%%%%%%%%%%%%%%%%%
%%%%%%%%%%%%%%%%%%%%%%%%%%%%%%%%%%%%%%%%%%%%%%%%%%%%%%%%
%%%%%%%%%%%%%%%%%%%%%%%%%%%%%%%%%%%%%%%%%%%%%%%%%%%%%%%%
%%%%%%%%%%%%%%%%%%%%%%%%%%%%%%%%%%%%%%%%%%%%%%%%%%%%%%%%
%%%%%%%%%%%%%%%%%%%%%%%%%%%%%%%%%%%%%%%%%%%%%%%%%%%%%%%%
%%%%%%%%%%%%%%%%%%%%%%%%%%%%%%%%%%%%%%%%%%%%%%%%%%%%%%%%
%%%%%%%%%%%%%%%%%%%%%%%%%%%%%%%%%%%%%%%%%%%%%%%%%%%%%%%%
%%%%%%%%%%%%%%%%%%%%%%%%%%%%%%%%%%%%%%%%%%%%%%%%%%%%%%%%
%%%%%%%%%%%%%%%%%%%%%%%%%%%%%%%%%%%%%%%%%%%%%%%%%%%%%%%%
%%%%%%%%%%%%%%%%%%%%%%%%%%%%%%%%%%%%%%%%%%%%%%%%%%%%%%%%
%%%%%%%%%%%%%%%%%%%%%%%%%%%%%%%%%%%%%%%%%%%%%%%%%%%%%%%%
%%%%%%%%%%%%%%%%%%%%%%%%%%%%%%%%%%%%%%%%%%%%%%%%%%%%%%%%
%%%%%%%%%%%%%%%%%%%%%%%%%%%%%%%%%%%%%%%%%%%%%%%%%%%%%%%%
#
