%%%%%%%%%%%%%%%%%%%%%%%%%%%%%%%%%%%%%%%%%%%%%%%%%%%%%%%%%%%%%%%%%%%%%%%%%%%%%%
%%%%%%%%%%%%%%%%%%%%%%%%%%%%%%%%%%%%%%%%%%%%%%%%%%%%%%%%%%%%%%%%%%%%%%%%%%%%%%
%%%%%%%%%%%%%%%%%%%%%%%%%%%%%%%%%%%%%%%%%%%%%%%%%%%%%%%%%%%%%%%%%%%%%%%%%%%%%%
%%%%%%%%%%%%%%%%%%%%%%%%%%%%%%%%%%%%%%%%%%%%%%%%%%%%%%%%%%%%%          %%%%%%%
%%%%%%%%%%%%%%%%%%%%%%%%%%%%%%%%%%%%%%%%%%%%%%%%%%%%%%%%%%%%%%         %%%%%%%
%%%%%%%%%%%%%        %%%%%%%%%%%%%%%%%%%%%%%%%%%%%%%%%%%%%%%%%%        %%%%%%%
%%%%%%%%%%%%%          %%%%%%%%%%%%%%%%%%%%%%%%%%%%%%%%%%%%%%%%        %%%%%%%
%%%%%%%%%%%%%            %%%%%%%%%%%%%%%%%%%%%%%%%%%%%%%%%%%%%%%       %%%%%%%
%%%%%%%%%%%%%                                     %%%%%%%%%%%%%%       %%%%%%%
%%%%%%%%%%%%%                                     %%%%%%%%%%%%%%%      %%%%%%%
%%%%%%%%%%%%%                                     %%%%%%%%%%%%%%%      %%%%%%%
%%%%%%%%%%%%%                                      %%%%%%%%%%%%%%      %%%%%%%
%%%%%%%%%%%%%           %%%%%%%%%%%%%%%%%%%%%%%%%  %%%%%%%%%%%%%%%     %%%%%%%
%%%%%%%%%%%%%          %%%%%%%%%%%%%%%%%%%%%%%%%%%  %%%%%%%%%%%%%%     %%%%%%%
%%%%%%%%%%%%%         %%%%%%%%%%%%%%%%%%%%%%%%%%%%% %%%%%%%%%%%%%%%    %%%%%%%
%%%%%%%%%%%%%       %%%%%%%%%%%%%%%%%%%%%%%%%%%%%%%  %%%%%%%%%%%%%%    %%%%%%%
%%%%%%%%%%%%%%%%%%%%%%%%%%%%%%%%%%%% %%%%%%%%%%%%%%% %%%%%%%%%%%%%%%   %%%%%%%
%%%%%%%%%%%%%%%%%%%%%%%%%%%%%%%%%%%  %%%%%%%%%%%%%%%  %%%%%%%%%%%%%%   %%%%%%%
%%%%%%%%%%%%%%%%%%%%%%%%%%%%%%%%%     %%%%%%%%%%%%%%% %%%%%%%%%%%%%%%  %%%%%%%
%%%%%%%%%%%%%%%%%%%%%%%%%%%%%%%%      %%%%%%%%%%%%%%% %%%%%%%%%%%%%%%  %%%%%%%
%%%%%%%%                               %%%%%%%%%%%%%%% %%%%%%%%%%%%%%  %%%%%%%
%%%%%%%%                                %%%%%%%%%%%%%% %%%%%%%%%%%%%%% %%%%%%%
%%%%%%%%                                %%%%%%%%%%%%%%% %%%%%%%%%%%%%% %%%%%%%
%%%%%%%%                                 %%%%%%%%%%%%%% %%%%%%%%%%%%%%%%%%%%%%
%%%%%%%%                                 %%%%%%%%%%%%%%% %%%%%%%%%%%%%%%%%%%%%
%%%%%%%%                                  %%%%%%%%%%%%%%%%%%%%%%%%%%%%%%%%%%%%
%%%%%%%%%%%%%%%%%%%%%%%%%%%%%%%%%%%%%%%%%%%%%%%%%%%%%%%%% %%%%%%%%%%%%%%%%%%%%
%%%%%%%%%%%%%%%%%%%%%%%%%%%%%%%%%%%%%%%%%%%%%%%%%%%%%%%%%%%%%%%%%%%%%%%%%%%%%%
%%%%%%%%%%%%%%%%%%%%%%%%%%%%%%%%%%%%%%%%%%%%%%%%%%%%%%%%%%%%%%%%%%%%%%%%%%%%%%
%%%%%%%%%%%%%%%%%%%%%%%%%%%%%%%%%%%%%%%%%%%%%%%%%%%%%%%%% %%%%%%%%%%%%%%%%%%%%
%%%%%%%%%%%%%%%%%%%%%%%%%%%%%%%%%%%%%%%%%%%%%%%%%%%%%%%%%%%%%%%%%%%%%%%%%%%%%%
%%%%%%%%%%%%%%%%%%%%%%%%%%%%%%%%%%%%%%%%%%%%%%%%%%%%%%%%%%%%%%%%%%%%%%%%%%%%%%
%%%%%%%%%%%%%%%%%%%%%%%%%%%%%%%%%%%%%%%%%%%%%%%%%%%%%%%%%%%%%%%%%%%%%%%%%%%%%%
%%%%%%%%                                   %%%%%%%%%%%%%%%%%%%%%%%%%%%%%%%%%%%
%%%%%%%%                                   %%%%%%%%%%%%%%%%%%%%%%%%%%%%%%%%%%%
%%%%%%%%                                   %%%%%%%%%%%%%%%%%%%%%%%%%%%%%%%%%%%
%%%%%%%%           %%%%%%%%%%%%%%%%%%%%%%%%%%%%%%%%%%%%%%%%%%%%%%%%%%% %%%%%%%
%%%%%%%%          %%%%%%%%%%%%%%%%%%%%%%%%%%%%%%%%%%%%%%%%%%%%%%%%%%%  %%%%%%%
%%%%%%%%         %%%%%%%%%%%%%%%%%%%%%%%%%%%%%%%%%%%%%%%%%%%%%%%%%%%%  %%%%%%%
%%%%%%%%        %%%%%%%%%%%%%%%%%%%%%%%%%%%%%%%%%%%%%%%%%%%%%%%%%%%%   %%%%%%%
%%%%%%%%       %%%%%%%%%%%%%%%%%%                   %%%%%%%%%%%%%%%    %%%%%%%
%%%%%%%%      %%%%%%%%%%%%%%%%%%%                   %%%%%%%%%%%%%%     %%%%%%%
%%%%%%%%     %%%%%%%%%%%%%%%%%%%%                   %%%%%%%%%%%%%%     %%%%%%%
%%%%%%%%    %%%%%%%%%%%%%%%%%%%%%                   %%%%%%%%%%%%%%     %%%%%%%
%%%%%%%%   %%%%%%%%%%%%%%%%%%%%%%                   %%%%%%%%%%%%%%     %%%%%%%
%%%%%%%%  %%%%%%%%%%%%%%%%%%%%%%%                   %%%%%%%%%%%%%%     %%%%%%%
%%%%%%%% %%%%%%%%%%%%%%%%%%%%%%%%                   %%%%%%%%%%%%%%     %%%%%%%
%%%%%%%%%%%%%%%%%%%%%%%%%%%%%%%%%                   %%%%%%%%%%%%%%     %%%%%%%
%%%%%%%%%%%%%%%%%%%%%%%%%%%%%%%%%%%%%%%%%%%%%%%%%%%%%%%%%%%%%%%%%%     %%%%%%%
%%%%%%%%%%%%%%%%%%%%%%%%%%%%%%%%%%%%%%%%%%%%%%%%%%%%%%%%%%%%%%%%%%     %%%%%%%
%%%%%%%%%%%%%%%%%%%%%%%%%%%%%%%%%%%%%%%%%%%%%%%%%%%%%%%%%%%%%%%%%%     %%%%%%%
%%%%%%%%%%%%%%%%%%%%%%%%%%%%%%%%%%%%%%%%%%%%%%%%%%%%%%%%%%%%%%%%%%     %%%%%%%
%%%%%%%%%%%%%%%%%%%%%%%%%%%%%%%%%%%%%%%%%%%%%%%%%%%%%%%%%%%%%%%%%%     %%%%%%%
%%%%%%%%                                   %%%%%%%%%%%%%%%%%%%%%%%%%%%%%%%%%%%
%%%%%%%%                                   %%%%%%%%%%%%%%%%%%%%%%%%%%%%%%%%%%%
%%%%%%%%                                   %%%%%%%%%%%%%%%%%%%%%%%%%%%%%%%%%%%
%%%%%%%%                                   %%%%%%%%%%%%%%%%%%%%%%%%%%%%%%%%%%%
%%%%%%%%                                   %%%%%%%%%%%%%%%%%%%%%%%%%%%%%%%%%%%
%%%%%%%%                                   %%%%%%%%%%%%%%%          %%%%%%%%%%
%%%%%%%%                                   %%%%%%%%%%%%%%%          %%%%%%%%%%
%%%%%%%%                                   %%%%%%%%%%%%%%%..........%%%%%%%%%%
%%%%%%%%                                   %%%%%%%%%%%%%%%..........%%%%%%%%%%
%%%%%%%%                                   %%%%%%%%%%%%%%%..........%%%%%%%%%%
%%%%%%%%                                   %%%%%%%%%%%%%%%..........%%%%%%%%%%
%%%%%%%%                                   %%%%%%%%%%%%%%%..........%%%%%%%%%%
%%%%%%%%                                   %%%%%%%%%%%%%%%..........%%%%%%%%%%
%%%%%%%%                                   %%%%%%%%%%%%%%%          %%%%%%%%%%
%%%%%%%%                                   %%%%%%%%%%%%%%%          %%%%%%%%%%
%%%%%%%%                                   %%%%%%%%%%%%%%%%%%%%%%%%%%%%%%%%%%%
%%%%%%%%                                   %%%%%%%%%%%%%%%%%%%%%%%%%%%%%%%%%%%
%%%%%%%%                                   %%%%%%%%%%%%%%%%%%%%%%%%%%%%%%%%%%%
%%%%%%%%                                    %%%%%%%%%%%%%%%%%%%%%%%%%%%%%%%%%%
%%%%%%%%                                     %%%%%%%%%%%%%%%%%%%%%%%%%%%%%%%%%
%%%%%%%%%%%%%%%%%%%%%%%%%%%%%%%%%%%%%%%%%%%%%%%%%%%%%%%%%%%%%%%%%%%%%%%%%%%%%%
%%%%%%%%%%%%%%%%%%%%%%%%%%%%%%%%%%%%%%%%%%%%%%%%%%%%%%%%%%%%%%%%%%%%%%%%%%%%%%
%%%%%%%%%%%%%%%%%%%%%%%%%%%%%%%%%%%%%%%%%%%%%%%%%%%%%%%%%%%%%%%%%%%%%%%%%%%%%%
#
%%%%%%%%%%%%%%%%%%%%%%%%%%%%%%%%%%%%%%%%%%%%%%%%%%%%%%%%%%%%%%%%%%%%%%%%%%%%%%
%%%%%%%%%%%%%%%%%%%%%%%%%%%%%%%%%%%%%%%%%%%%%%%%%%%%%%%%%%%%%%%%%%%%%%%%%%%%%%
%%%%%%%%%%%%%%%%%%%%%%%%%%%%%%%%%%%%%%%%%%%%%%%%%%%%%%%%%%%%%%%%%%%%%%%%%%%%%%
%%%%%%%%%%%%%%%%%%%%%%%%%%%%%%%%%%%%%%%%%%%%%%%%%%%%%%%%%%%%%%%%%%%%%%%%%%%%%%
%%%%%%%%%%%%%%%%%%%%%%%%%%%%%%%%%%%%%%%%%%%%%%%%%%%%%%%%%%%               %%%%
%%%%%%%%%%%%%%%%%%%%%%%%%%%%%%%%%%%%%%%%%%%%%%%%%%%%%%%%%%%%              %%%%
%%%%%%%%%%%%%%%%%%%%%%%%%%%%%%%%%%%%%%%%%%%%%%%%%%%%%%%%%%%%              %%%%
%%%%%%%%%                 %%%%%%%%%%%%%%%%%%%%%%%%%%%%%%%%%%%             %%%%
%%%%%%%%%                   %%%%%%%%%%%%%%%%%%%%%%%%%%%%%%%%%             %%%%
%%%%%%%%%                                            %%%%%%%%             %%%%
%%%%%%%%% P                   %%%%%%%%%%%%%%          %%%%%%%%            %%%%
%%%%%%%%%                   %%%%%%%%%%%%%%%%%%        %%%%%%%%            %%%%
%%%%%%%%%                 %%%%%%%%%%%%%%%%%%%%        %%%%%%%%%           %%%%
%%%%%%%%%                %%%%%%%%%%%%%%%%%%%%%%        %%%%%%%%           %%%%
%%%%%%%%%%%%%%%%%%%%%%%%%%%%%%%%%%%%%%%%%%%%%%%%       %%%%%%%%%          %%%%
%%%%%%%%%%%%%%%%%%%%%%%%%%%%%%%%%%%%%%%%%%%%%%%%        %%%%%%%%          %%%%
%%%%%%%%%%%%%%%%%%%%%%%%%%%%%%%%%%%%%%%%%%%%%%%%%       %%%%%%%%%         %%%%
%%%%%%%%%%%%%%%%%%%%%%%%%%%%%%%%%%%%%%%%%%%%%%%%%        %%%%%%%%         %%%%
%%%%%%%%%%%%%%%%%%%%%%%%%%%%%%%          %%%%%%%%%       %%%%%%%%         %%%%
%%%%%%%%%%%%%%%%%%%%%%%%%%%%%%           %%%%%%%%%        %%%%%%%%        %%%%
%%%%%%%%%%%%%%%%%%%%%%%%%%%%%             %%%%%%%%%       %%%%%%%%        %%%%
%%%%%%%%%%%%%%%%%%%%%%%%%%%                %%%%%%%%       %%%%%%%%%       %%%%
%%%%                                       %%%%%%%%%       %%%%%%%%       %%%%
%%%%                                        %%%%%%%%       %%%%%%%%%      %%%%
%%%%       %%%%%%%%%%%%%%%%%%%%%%%%%%%%%%%%%%%%%%%%%%       %%%%%%%%      %%%%
%%%%      %%%%%%%%%%%%%%%%%%%%%%%%%%%%%%%%%%%%%%%%%%%%      %%%%%%%%%     %%%%
%%%%     %%%%%%%%%%%%%%%%%%%%%%%%%%%%%%%%%%%%%%%%%%%%%       %%%%%%%%     %%%%
%%%%     %%%%%%%%%%%%%%%%%%%%%%%%%%%%%%%%%%%%%%%%%%%%%       %%%%%%%%     %%%%
%%%%     %%%%%%%%%%%%%%%%%%%%%%%%%%%%%%%%%%%%%%%%%%%%%        %%%%%%%     %%%%
%%%%     %%%%%%%%%%%%%%%%%%%%%%%%%%%%%%%%%%%%%%%%%%%%%        %%%%%%%     %%%%
%%%%     %%%%%%%%%%%%%%%%%%%%%%%%%%%%%%%%%%%%%%%%%%%%%        %%%%%%%     %%%%
%%%%     %%%%%%%%%%%%%%%%%%%%%%%%%%%%%%%%%%%%%%%%%%%%%        %%%%%%%     %%%%
%%%%      %%%%%%%%%%%%%%%%%%%%%%%%%%%%%%%%%%%%%%%%%%%%       %%%%%%%%     %%%%
%%%%       %%%%%%%%%%%%%%%%%%%%%%%%%%%%%%%%%%%%%%%%%%%      %%%%%%%%%     %%%%
%%%%                    %%%%%%%%%%%%%%%%%%%%%%%%%%%%%%     %%%%%%%%%%     %%%%
%%%%                   %%%%%%%%%%%%%%%%%%%%%%%%%%%%%%%    %%%%%%%%%%      %%%%
%%%%                  %%%%%%%%%%%%%%%%%%%%%%%%%%%%%%%%    %%%%%%%%%%      %%%%
%%%%                 %%%%%%%%%%%%%%%%%%%%%%%%%%%%%%%%%   %%%%%%%%%%       %%%%
%%%%                %%%%%%%%%%%%%%%%%%%%%%%%%%%%%%%%%%  %%%%%%%%%%        %%%%
%%%%               %%%%%%%%%%%%%%%%%%%%%%%%%%%%%%%%%%%  %%%%%%%%%         %%%%
%%%%              %%%%%%%%%%%%%%%%%%%%%%%%%%%%%%%%%%%  %%%%%%%%%          %%%%
%%%%             %%%%%%%%%%%%%%%%%%%%%%%%%%%%%%%%%%%   %%%%%%%%           %%%%
%%%%            %%%%%%%%%%%%%                          %%%%%%%%           %%%%
%%%%           %%%%%%%%%%%%%%                          %%%%%%%%           %%%%
%%%%          %%%%%%%%%%%%%%%                          %%%%%%%%           %%%%
%%%%         %%%%%%%%%%%%%%%%                          %%%%%%%%           %%%%
%%%%        %%%%%%%%%%%%%%%%%                          %%%%%%%%           %%%%
%%%%       %%%%%%%%%%%%%%%%%%%%%%%%%%%%%%%%%%%%%%%%%%  %%%%%%%%           %%%%
%%%%      %%%%%%%%%%%%%%%%%%%%%%%%%%%%%%%%%%%%%%%%%%%% %%%%%%%%           %%%%
%%%%     %%%%%%%%%%%%%%%%%%%%%%%%%%%%%%%%%%%%%%%%%%%%% %%%%%%%%           %%%%
%%%%     %%%%%%%%%%%%%%%%%%%%%%%%%%%%%%%%%%%%%%%%%%%%% %%%%%%%%           %%%%
%%%%     %%%%%%%%%%%%%%%%%%%%%%%%%%%%%%%%%%%%%%%%%%%%% %%%%%%%%           %%%%
%%%%      %%%%%%%%%%%%%%%%%%%%%%%%%%%%%%%%%%%%%%%%%%%% %%%%%%%%%%%%%%%%%%%%%%%
%%%%       %%%%%%%%%%%%%%%%%%%%%%%%%%%%%%%%%%%%%%%%%%% %%%%%%%%%%%%%%%%%%%%%%%
%%%%                                           %%%%%%% %%%%%%%%%%%%%%%%%%%%%%%
%%%%                                           %%%%%%% %%%%%%%%%%%%%%%%%%%%%%%
%%%%                                           %%%%%%%  %%%%%%%%%%%%%%%%%%%%%%
%%%%                                           %%%%%%%  %%%%%%%%%%%%%%%%%%%%%%
%%%%                                           %%%%%%%   %%%%%%%%%%%%%%%%%%%%%
%%%%                                           %%%%%%%      ......      %%%%%%
%%%%                                           %%%%%%%     ........     %%%%%%
%%%%                                           %%%%%%%     ........     %%%%%%
%%%%                                           %%%%%%%     ........     %%%%%%
%%%%                                           %%%%%%%     ........     %%%%%%
%%%%                                           %%%%%%%     ........     %%%%%%
%%%%                                           %%%%%%%     ........     %%%%%%
%%%%                                           %%%%%%%      ......      %%%%%%
%%%%                                           %%%%%%%%%%%%%%%%%%%%%%%%%%%%%%%
%%%%                                           %%%%%%%%%%%%%%%%%%%%%%%%%%%%%%%
%%%%                                           %%%%%%%%%%%%%%%%%%%%%%%%%%%%%%%
%%%%                                           %%%%%%%%%%%%%%%%%%%%%%%%%%%%%%%
%%%%                                           %%%%%%%%%%%%%%%%%%%%%%%%%%%%%%%
%%%%%%%%%%%%%%%%%%%%%%%%%%%%%%%%%%%%%%%%%%%%%%%%%%%%%%%%%%%%%%%%%%%%%%%%%%%%%%
%%%%%%%%%%%%%%%%%%%%%%%%%%%%%%%%%%%%%%%%%%%%%%%%%%%%%%%%%%%%%%%%%%%%%%%%%%%%%%
%%%%%%%%%%%%%%%%%%%%%%%%%%%%%%%%%%%%%%%%%%%%%%%%%%%%%%%%%%%%%%%%%%%%%%%%%%%%%%
%%%%%%%%%%%%%%%%%%%%%%%%%%%%%%%%%%%%%%%%%%%%%%%%%%%%%%%%%%%%%%%%%%%%%%%%%%%%%%
#
%%%%%%%%%%%%%%%%%%%%%%%%%%%%%%%%%%%%%%%%%%%%%%%%%%%%%%%%%%%%%%%%%%%%%%%%%%%%%%
%%%%%%%%%%%%%%%%%%%%%%%%%%%%%%%%%%%%%%%%%%%%%%%%%%%%%%%%%%%%%%%%%%%%%%%%%%%%%%
%%%%%%%%%%%%%%%%%%%%%%%%%%%%%%%%%%%%%%%%%%%%%%%%%%%%%%%%%%%%%%%%%%%%%%%%%%%%%%
%%%%%%%%%%%%%%%%%%%%%%%%%%%%%%%%%%%%%%%%%%%%%%%%%%%%%%%%%%%%%%%%%%%%%%%%%%%%%%
%%%%%%%%%%%%%%%%%%%%%%%%%%%%%%%%%%%%%%%%%%%%%%%%%%%%%%%%%%%%%%%%%%%%%%%%%%%%%%
%%%%%%%%%%%%%%%%%%%%%%%%%%%%%%%%%%%%%%%%%%%%%%%%%%%%%%%%%%%%%%%%%%%%%%%%%%%%%%
%%%%%%%%%%%%%%%%%%%%%%%%%%%%%%%%%%%%%%%%%%%%%%%%%%%%%%%%%%%%%%%%%%%%%%%%%%%%%%
%%%%%%%%%%%%%%%%%%%%%%%%%%%%%%%%%%%%%%%%%%%%%%%%%%%%%%%%%%%%%%%%%%%%%%%%%%%%%%
%%%%%%%%%%%%%%%%%%%%%%%%%%%%%%%%%%%%%%%%%%%%%%%%%%%%%%%%%%%%%               %%
%%%%%%%%%%%%%%%%%%%%%%%%%%%%%%%%%%%%%%%%%%%%%%%%%%%%%%%%%%%%%%              %%
%%%%%%%%                 %%%%%%%%%%%%%%%%%%%%%%%%%%%%%%%%%%%%%              %%
%%%%%%%%%%%%%%%%%%%%%%%%%%%%%%%%%%%%%%%%%%%%%%%%%%%%%%%%%%%%%%%             %%
%%%%%%%%%%%%%%%%%%%%%%%%%%%%%%%%%%%%%%%%%%%%%%%%%%%%%%%%%%%%%%%             %%
%%%%%%%%%%%%%%%%%%%%%%%%%%%%%%%%%%%%%%%%%%%%%%%%       %%%%%%%%%            %%
%%%%%%%%%%%%%%%%%%%%%%%%%%%%%%%%%%%%%%%%%%%%%%%%       %%%%%%%%%            %%
%%%%%%%%%%%%%%%%%%%%%%%%%%%%%%%%%%%%%%%%%%%%%%%%%      %%%%%%%%%            %%
%%%%%%%%%%%%%%%%%%%%%%%%%%%%%%%%%%%%%%%%%%%%%%%%%       %%%%%%%%%           %%
%%%%%%%%%%%%%%%%%%%%%%%%%%%%%%%%%%%%%%%%%%%%%%%%%%      %%%%%%%%%           %%
%%%%%%%%%%%%%%%%%%%%%%%%%%%%%%%%%%%%%%%%%%%%%%%%%%       %%%%%%%%%          %%
%%%%%%%%%%%%%%%%%%%%%%%%%%%%%%%%%%%%%%%%%%%%%%%%%%%      %%%%%%%%%          %%
%%%%%%%%%%%%%%%%%%%%%%%%%%%%%%%%%%%%%%%%%%%%%%%%%%%%      %%%%%%%%%         %%
%%%%%%%%%%%%%%%%%%%%%%%%%%%%%%%%%%%%%%%%%%%%%%%%%%%%      %%%%%%%%%         %%
%%%%%%%%%%%%%%%%%%%%%%%%%%%%%%%%%%%%%%%%%%%%%%%%%%%%%      %%%%%%%%%        %%
%%%%%%%%%%%%%%%%%%%%%%%%%%%%%%%%%%%%%%%%%%%%%%%%%%%%%      %%%%%%%%%        %%
%%% %%%%%%%%%%%%%%%%%%%%%%%%%%%%%%%%%%%%%%%%%%%%%%%%%      %%%%%%%%%        %%
%%%        %%%%%%%%%%%%%%%%%%%%%%%%%%%%%%%%%%%%%%%%%%       %%%%%%%%        %%
%%%        %%%%%%%%%%%%%%%%%%%%%%%%%%%%%%%%%%%%%%%%%%       %%%%%%%%        %%
%%%        %%%%%%%%%%%%%%%%%%%%%%%%%%%%%%%%%%%%%%%%%%        %%%%%%%        %%
%%%        %%%%%%%%%%%%%%%%%%%%%%%%%%%%%%%%%%%%%%%%%%        %%%%%%%        %%
%%%        %%%%%%%%%%%%%%%%%%%%%%%%%%%%%%%%%%%%%%%%%%         %%%%%%        %%
%%%        %%%%%%%%%%%%%%%%%%%%%%%%%%%%%%%%%%%%%%%%%%        %%%%%%%        %%
%%%        %%%%%%%%%%%%%%%%%%%%%%%%%%%%%%%%%%%%%%%%%%       %%%%%%%%        %%
%%%        %%%%%%%%%%%%%%%%%%%%%%%%%%%%%%%%%%%%%%%%%%      %%%%%%%%%        %%
%%%        %%%%%%%%%%%%%%%%%%%%%%%%%%%%%%%%%%%%%%%%%%     %%%%%%%%%%        %%
%%%        %%%%%%%%%%%%%%%%%%%%%%%%%%%%%%%%%%%%%%%%%%    %%%%%%%%%%%        %%
%%%        %%%%%%%%%%%%%%%%%%%%%%%%%%%%%%%%%%%%%%%%%%    %%%%%%%%%%%        %%
%%%        %%%%%%%%%%%%%%%%%%%%%%%%%%%%%%%%%%%%%%%%%%    %%%%%%%%%%%        %%
%%%         %%%%%%%%%%%%%%%%%%%%%%%%%%%%%%%%%%%%%%%%%    %%%%%%%%%%%        %%
%%%              %%%%%%%%%%%%%%%%%%%%%%%%%%%%%%%%%%%%    %%%%%%%%%%%        %%
%%%             %%%%%%%%%%%%%%%%%%%%%%%%%%%%%%%%%%%%%    %%%%%%%%%%         %%
%%%            %%%%%%%%%%%%%%%%%%%%%%%%%%%%%%%%%%%%%%    %%%%%%%%%          %%
%%%           %%%%%%%%%%%%%%%%%%%%%%%%%%%%%%%%%%%%%%%    %%%%%%%%           %%
%%%          %%%%%%%%%%%%%%%%%%%%%%%%%%%%%%%%%%%%%%%%    %%%%%%%            %%
%%%         %%%%%%%%%%%%%%%%%%%%%%%%%%%%%%%%%%%%%%%%%    %%%%%%%            %%
%%%        %%%%%%%%%%%%%%%%%%%%%%%%%%%%%%%%%%%%%%%%%     %%%%%%             %%
%%%        %%%%%%%%%%%%%%%%%%%%%%%%%%%%%%%%%%%%%%%%%%    %%%%%              %%
%%%        %%%%%%%%%%%%%%%%%%%%%%%%%%%%%%%%%%%%%%%%%%    %%%%               %%
%%%        %%%%%%%%%%%%%%%%%%%%%%%%%%%%%%%%%%%%%%%%%%    %%%%               %%
%%%        %%%%%%%%%%%%%%%%%%%%%%%%%%%%%%%%%%%%%%%%%%    %%%%%%%%%%%%%%%%%%%%%
%%%        %%%%%%%%%%%%%%%%%%%%%%%%%%%%%%%%%%%%%%%%%%    %%%%%%%%%%%%%%%%%%%%%
%%%        %%%%%%%%%%%%%%%%%%%%%%%%%%%%%%%%%%%%%%%%%%    %%%%%%%%%%%%%%%%%%%%%
%%%        %%%%%%%%%%%%%%%%%%%%%%%%%%%%%%%%%%%%%%%%%%    %%%%%%%%%%%%%%%%%%%%%
%%%        %%%%%%%%%%%%%%%%%%%%%%%%%%%%%%%%%%%%%%%%%%    %%%%%%%%%%%%%%%%%%%%%
%%%        %%%%%%%%%%%%%%%%%%%%%%%%%%%%%%%%%%%%%%%%%%    %%%%%%%%%%%%%%%%%%%%%
%%%        %%%%%%%%%%%%%%%%%%%%%%%%%%%%%%%%%%%%%%%%%%    %%%%%%%%%%%%%%%%%%%%%
%%%        %%%%%%%%%%%%%%%%%%%%%%%%%%%%%%%%%%%%%%%%%%    %%%%%%%%%%%%%%%%%%%%%
%%%        %%%%%%%%%%%%%%%%%%%%%%%%%%%%%%%%%%%%%%%%%%    %%%%%%%%%%%%%%%%%%%%%
%%%         %%%%%%%%%%%%%%%%%%%%%%%%%%%%%%%%%%%%%%%%%    %%%%%%%%%%%%%%%%%%%%%
%%%                                             %%%%%    %%%%%%%%%%%%%%%%%%%%%
%%%                                             %%%%%    %%%%%%%%%%%%%%%%%%%%%
%%%                                             %%%%%    %%%%%%%%%%%%%%%%%%%%%
%%%                                             %%%%%    %%%%%%%%%%%%%%%%%%%%%
%%%                                             %%%%%      %%%%%%%%%%%%%%%%%%%
%%%                                             %%%%%%%%%%%%%%%%%%%%%%%%%%%%%%
%%%                                             %%%%%%%%%%%%%%%%%%%%%%%%%%%%%%
%%%                                             %%%%%%%%%%%%%%%%%%%%%%%%%%%%%%
%%%                                             %%%%%%%%%%%%%%%%%%%%%%%%%%%%%%
%%%                                             %%%%%%%%%%%%%%%%%%%%%%%%%%%%%%
%%%%%%%%%%%%%%%%%%%%%%%%%%%%%%%%%%%%%%%%%%%%%%%%%%%%%%%%%%%%%%%%%%%%%%%%%%%%%%
%%%%%%%%%%%%%%%%%%%%%%%%%%%%%%%%%%%%%%%%%%%%%%%%%%%%%%%%%%%%%%%%%%%%%%%%%%%%%%
%%%%%%%%%%%%%%%%%%%%%%%%%%%%%%%%%%%%%%%%%%%%%%%%%%%%%%%%%%%%%%%%%%%%%%%%%%%%%%
%%%%%%%%%%%%%%%%%%%%%%%%%%%%%%%%%%%%%%%%%%%%%%%%%%%%%%%%%%%%%%%%%%%%%%%%%%%%%%
%%%%%%%%%%%%%%%%%%%%%%%%%%%%%%%%%%%%%%%%%%%%%%%%%%%%%%%%%%%%%%%%%%%%%%%%%%%%%%
%%%%%%%%%%%%%%%%%%%%%%%%%%%%%%%%%%%%%%%%%%%%%%%%%%%%%%%%%%%%%%%%%%%%%%%%%%%%%%
%%%%%%%%%%%%%%%%%%%%%%%%%%%%%%%%%%%%%%%%%%%%%%%%%%%%%%%%%%%%%%%%%%%%%%%%%%%%%%
%%%%%%%%%%%%%%%%%%%%%%%%%%%%%%%%%%%%%%%%%%%%%%%%%%%%%%%%%%%%%%%%%%%%%%%%%%%%%%
#
